[
  [ 7,0,0,0,0,0,0,0,0,0,0,0,0,0,0,0,0,0,0,0,0,0,0,0,0,0,0,0,0,0,0,0,0,0,0,0,0,0,0,0,0,0,0,0,0,0,0,0,0,0,0,0,0,0,0,0,0,0,0,0,0,0,0,0,0,0,0,0,0,0,0,0,0,0,0,0,0,0,0,0,0,0,0,0,0,0,0,0,0,0,0,0,0,0,0,0,0,0,0,0,0,0,0,0,0,0 ],
  [ 7,0,0,0,0,0,0,0,0,0,0,4,5,0,0,0,0,5,4,0,0,0,0,0,0,0,0,0,0,0,0,0,0,0,0,0,0,4,5,0,0,0,0,5,4,0,0,0,0,0,0,0,0,0,0,0,0,0,0,0,0,0,0,4,5,0,0,0,0,5,4,0,0,0,0,0,0,0,0,0,0,0,0,0,0,0,0,0,0,4,5,0,0,0,0,5,4,0,0,0,0,0,0,0,0,0 ],
  [ 7,0,0,0,0,0,0,0,0,0,1,2,4,5,0,0,5,4,2,1,0,0,0,0,0,0,0,0,0,0,0,0,0,0,0,0,1,2,4,5,0,0,5,4,2,1,0,0,0,0,0,0,0,0,0,0,0,0,0,0,0,0,1,2,4,5,0,0,5,4,2,1,0,0,0,0,0,0,0,0,0,0,0,0,0,0,0,0,1,2,4,5,0,0,5,4,2,1,0,0,0,0,0,0,0,0 ],
  [ 7,0,0,0,0,0,0,0,0,1,1,2,2,4,5,5,4,2,1,1,1,0,0,0,0,0,0,0,0,0,0,0,0,0,0,1,1,2,2,4,5,5,4,2,1,1,1,0,0,0,0,0,0,0,0,0,0,0,0,0,0,1,1,2,2,4,5,5,4,2,1,1,1,0,0,0,0,0,0,0,0,0,0,0,0,0,0,1,1,2,2,4,5,5,4,2,1,1,1,0,0,0,0,0,0,0 ],
  [ 7,0,0,0,0,0,0,0,1,1,3,1,2,4,5,5,4,2,1,3,1,1,0,0,0,0,0,0,0,0,0,0,0,0,1,1,3,1,2,4,5,5,4,2,1,3,1,1,0,0,0,0,0,0,0,0,0,0,0,0,1,1,3,1,2,4,5,5,4,2,1,3,1,1,0,0,0,0,0,0,0,0,0,0,0,0,1,1,3,1,2,4,5,5,4,2,1,3,1,1,0,0,0,0,0,0 ],
  [ 7,0,0,0,0,0,0,1,1,1,1,1,2,4,5,5,4,2,1,1,1,1,1,0,0,0,0,0,0,0,0,0,0,1,1,1,1,1,2,4,5,5,4,2,1,1,1,1,1,0,0,0,0,0,0,0,0,0,0,1,1,1,1,1,2,4,5,5,4,2,1,1,1,1,1,0,0,0,0,0,0,0,0,0,0,1,1,1,1,1,2,4,5,5,4,2,1,1,1,1,1,0,0,0,0,0 ],
  [ 7,0,0,0,0,0,1,1,1,3,1,1,2,4,5,5,4,2,1,1,3,1,1,1,0,0,0,0,0,0,0,0,1,1,1,3,1,1,2,4,5,5,4,2,1,1,3,1,1,1,0,0,0,0,0,0,0,0,1,1,1,3,1,1,2,4,5,5,4,2,1,1,3,1,1,1,0,0,0,0,0,0,0,0,1,1,1,3,1,1,2,4,5,5,4,2,1,1,3,1,1,1,0,0,0,0 ],
  [ 7,0,0,0,0,1,1,1,1,1,1,1,2,4,5,5,4,2,1,1,1,1,1,1,1,0,0,0,0,0,0,1,1,1,1,1,1,1,2,4,5,5,4,2,1,1,1,1,1,1,1,0,0,0,0,0,0,1,1,1,1,1,1,1,2,4,5,5,4,2,1,1,1,1,1,1,1,0,0,0,0,0,0,1,1,1,1,1,1,1,2,4,5,5,4,2,1,1,1,1,1,1,1,0,0,0 ],
  [ 7,0,0,0,1,1,1,3,1,1,1,2,2,4,5,5,4,2,2,1,1,1,3,1,1,1,0,0,0,0,1,1,1,3,1,1,1,2,2,4,5,5,4,2,2,1,1,1,3,1,1,1,0,0,0,0,1,1,1,3,1,1,1,2,2,4,5,5,4,2,2,1,1,1,3,1,1,1,0,0,0,0,1,1,1,3,1,1,1,2,2,4,5,5,4,2,2,1,1,1,3,1,1,1,0,0 ],
  [ 7,0,0,1,1,3,1,1,1,1,1,2,4,5,0,0,5,4,2,1,1,1,1,1,3,1,1,0,0,1,1,3,1,1,1,1,1,2,4,5,0,0,5,4,2,1,1,1,1,1,3,1,1,0,0,1,1,3,1,1,1,1,1,2,4,5,0,0,5,4,2,1,1,1,1,1,3,1,1,0,0,1,1,3,1,1,1,1,1,2,4,5,0,0,5,4,2,1,1,1,1,1,3,1,1,0 ],
  [ 7,0,4,2,2,1,1,1,1,2,2,4,5,5,0,0,5,5,4,2,2,1,1,1,1,2,2,4,4,2,2,1,1,1,1,2,2,4,5,5,0,0,5,5,4,2,2,1,1,1,1,2,2,4,4,2,2,1,1,1,1,2,2,4,5,5,0,0,5,5,4,2,2,1,1,1,1,2,2,4,4,2,2,1,1,1,1,2,2,4,5,5,0,0,5,5,4,2,2,1,1,1,1,2,2,4 ],
  [ 7,0,5,4,2,2,2,2,2,2,4,5,5,0,0,0,0,5,5,4,2,2,2,2,2,2,4,5,5,4,2,2,2,2,2,2,4,5,5,0,0,0,0,5,5,4,2,2,2,2,2,2,4,5,5,4,2,2,2,2,2,2,4,5,5,0,0,0,0,5,5,4,2,2,2,2,2,2,4,5,5,4,2,2,2,2,2,2,4,5,5,0,0,0,0,5,5,4,2,2,2,2,2,2,4,5 ],
  [ 7,0,0,5,4,4,4,4,4,4,5,5,0,0,0,0,0,0,5,5,4,4,4,4,4,4,5,0,0,5,4,4,4,4,4,4,5,5,0,0,0,0,0,0,5,5,4,4,4,4,4,4,5,0,0,5,4,4,4,4,4,4,5,5,0,0,0,0,0,0,5,5,4,4,4,4,4,4,5,0,0,5,4,4,4,4,4,4,5,5,0,0,0,0,0,0,5,5,4,4,4,4,4,4,5,0 ],
  [ 7,0,0,0,0,5,5,5,5,5,0,0,0,0,0,0,0,0,0,0,5,5,5,5,5,0,0,0,0,0,0,5,5,5,5,5,0,0,0,0,0,0,0,0,0,0,5,5,5,5,5,0,0,0,0,0,0,5,5,5,5,5,0,0,0,0,0,0,0,0,0,0,5,5,5,5,5,0,0,0,0,0,0,5,5,5,5,5,0,0,0,0,0,0,0,0,0,0,5,5,5,5,5,0,0,0 ],
  [ 7,0,0,0,0,0,0,0,0,0,0,0,0,0,0,0,0,0,0,0,0,0,0,0,0,0,0,0,0,0,0,0,0,0,0,0,0,0,0,0,0,0,0,0,0,0,0,0,0,0,0,0,0,0,0,0,0,0,0,0,0,0,0,0,0,0,0,0,0,0,0,0,0,0,0,0,0,0,0,0,0,0,0,0,0,0,0,0,0,0,0,0,0,0,0,0,0,0,0,0,0,0,0,0,0,0 ],
  [ 7,7,7,7,7,7,7,7,7,7,7,7,7,7,7,7,7,7,7,7,7,7,7,7,7,7,7,7,7,7,7,7,7,7,7,7,7,7,7,7,7,7,7,7,7,7,7,7,7,7,7,7,7,7,7,7,7,7,7,7,7,7,7,7,7,7,7,7,7,7,7,7,7,7,7,7,7,7,7,7,7,7,7,7,7,7,7,7,7,7,7,7,7,7,7,7,7,7,7,7,7,7,7,7,7,7 ]
]